_______G
_O__O__O
S_______
__O_____
_O_O_O__
________
S_______
_G______ 