S_________
____O_____
O_________
G_____O___
_O_______O
__________
O_____O__G
___S_____O
__________
___O______
