S____O______
_____O____OO
__O________G
____________
_OG___S_____
____O______O
_________O__
__O_________
___O__O_____
O___________
_O___O__S___
__G__O______
